,apparentTemperatureMax,apparentTemperatureMin,sunsetTime,sunriseTime,daylight,daylight in hours
0,55.17,40.72,1420127437,1420101068,26369,7.324722222
1,50.66,29.15,1420213905,1420187455,26450,7.347222222
2,33.54,25.84,1420300377,1420273838,26539,7.371944444
3,35.16,23.05,1420386851,1420360217,26634,7.398333333
4,41.09,30.2,1420473329,1420446592,26737,7.426944444
5,38.92,30.1,1420559810,1420532963,26847,7.4575
6,50.06,30.91,1420646294,1420619331,26963,7.489722222
7,39.34,32.4,1420732781,1420705695,27086,7.523888889
8,55.22,33.02,1420819270,1420792056,27214,7.559444444
9,54.07,25.48,1420905762,1420878413,27349,7.596944444
10,36.22,24.23,1420992256,1420964767,27489,7.635833333
11,40.57,28.8,1421078753,1421051117,27636,7.676666667
12,30.03,23.84,1421165252,1421137464,27788,7.718888889
13,31.68,22.88,1421251753,1421223807,27946,7.762777778
14,35.64,25.17,1421338257,1421310147,28110,7.808333333
15,29.66,23.31,1421424762,1421396484,28278,7.855
16,30.74,25.24,1421511269,1421482818,28451,7.903055556
17,27.89,19.75,1421597778,1421569149,28629,7.9525
18,28.82,21.64,1421684289,1421655477,28812,8.003333333
19,26.89,22.98,1421770801,1421741802,28999,8.055277778
20,28.09,24.36,1421857314,1421828124,29190,8.108333333
21,32.76,25.45,1421943829,1421914444,29385,8.1625
22,33.67,23.95,1422030346,1422000760,29586,8.218333333
23,34.01,25.29,1422116863,1422087074,29789,8.274722222
24,42.23,31.23,1422203382,1422173386,29996,8.332222222
25,41.12,29.74,1422289901,1422259695,30206,8.390555556
26,38.93,29.24,1422376422,1422346001,30421,8.450277778
27,38.04,21.69,1422462943,1422432305,30638,8.510555556
28,26.09,20.98,1422549465,1422518607,30858,8.571666667
29,29.4,19.32,1422635988,1422604906,31082,8.633888889
30,27.86,22.86,1422722511,1422691204,31307,8.696388889
31,26.29,19.33,1422809035,1422777499,31536,8.76
32,25.83,18.01,1422895560,1422863792,31768,8.824444444
33,28.58,19.56,1422982084,1422950083,32001,8.889166667
34,28.87,21.61,1423068610,1423036372,32238,8.955
35,36.28,26.79,1423155135,1423122659,32476,9.021111111
36,37.52,31.4,1423241661,1423208944,32717,9.088055556
37,38.22,27.45,1423328186,1423295228,32958,9.155
38,37,25.69,1423414712,1423381509,33203,9.223055556
39,41.96,27.82,1423501238,1423467789,33449,9.291388889
40,35.96,25.65,1423587764,1423554068,33696,9.36
41,32.81,24.98,1423674290,1423640345,33945,9.429166667
42,34.97,29.84,1423760816,1423726620,34196,9.498888889
43,36.17,26.64,1423847342,1423812894,34448,9.568888889
44,41.29,33.98,1423933868,1423899166,34702,9.639444444
45,40.13,30.92,1424020393,1423985437,34956,9.71
46,38.85,28.06,1424106919,1424071706,35213,9.781388889
47,37.96,24.25,1424193444,1424157974,35470,9.852777778
48,44.42,34.43,1424279969,1424244241,35728,9.924444444
49,38.54,31.64,1424366493,1424330507,35986,9.996111111
50,35.32,27.69,1424453017,1424416772,36245,10.06805556
51,34.53,25.19,1424539542,1424503035,36507,10.14083333
52,35.13,25.17,1424626065,1424589298,36767,10.21305556
53,31.67,25.1,1424712589,1424675559,37030,10.28611111
54,30.99,25.55,1424799112,1424761819,37293,10.35916667
55,42.8,30.08,1424885634,1424848078,37556,10.43222222
56,43.73,26.79,1424972157,1424934337,37820,10.50555556
57,36.58,26.03,1425058679,1425020594,38085,10.57916667
58,39.65,31.92,1425145200,1425106851,38349,10.6525
59,35.89,26.34,1425231722,1425193107,38615,10.72638889
60,28.7,24.89,1425318243,1425279362,38881,10.80027778
61,30.53,24.3,1425404763,1425365616,39147,10.87416667
62,40.53,26.83,1425491284,1425451870,39414,10.94833333
63,42.02,31.96,1425577803,1425538123,39680,11.02222222
64,43.85,37.18,1425664323,1425624375,39948,11.09666667
65,53.01,37.7,1425750842,1425710627,40215,11.17083333
66,42.91,27.65,1425837361,1425796878,40483,11.24527778
67,42.95,23.94,1425923880,1425883128,40752,11.32
68,43.58,27.99,1426010398,1425969378,41020,11.39444444
69,40.7,25.03,1426096916,1426055628,41288,11.46888889
70,51.63,26.97,1426183434,1426141877,41557,11.54361111
71,37.23,30.12,1426269951,1426228126,41825,11.61805556
72,35.4,27.44,1426356468,1426314375,42093,11.6925
73,40.06,30.29,1426442985,1426400623,42362,11.76722222
74,37.73,32.74,1426529502,1426486871,42631,11.84194444
75,44.35,33.07,1426616018,1426573119,42899,11.91638889
76,42.44,31.53,1426702534,1426659366,43168,11.99111111
77,49.48,30.94,1426789050,1426745613,43437,12.06583333
78,53.06,35.92,1426875566,1426831860,43706,12.14055556
79,37.63,32.37,1426962082,1426918107,43975,12.21527778
80,50.22,26.79,1427048598,1427004354,44244,12.29
81,45.71,29.61,1427135113,1427090601,44512,12.36444444
82,42.63,26.43,1427221628,1427176848,44780,12.43888889
83,44.29,26.93,1427308144,1427263095,45049,12.51361111
84,40.16,26.03,1427394659,1427349342,45317,12.58805556
85,41.53,28.61,1427481174,1427435589,45585,12.6625
86,54.34,32.02,1427567689,1427521836,45853,12.73694444
87,38.74,29.08,1427654204,1427608083,46121,12.81138889
88,40.75,25.45,1427740719,1427694330,46389,12.88583333
89,39.07,25.15,1427827234,1427780578,46656,12.96
90,36.74,26.34,1427913749,1427866826,46923,13.03416667
91,47.4,25.68,1428000264,1427953074,47190,13.10833333
92,41.9,32.02,1428086779,1428039323,47456,13.18222222
93,50.46,37.07,1428173294,1428125571,47723,13.25638889
94,59.64,41.26,1428259809,1428211821,47988,13.33
95,60.08,36.03,1428346325,1428298070,48255,13.40416667
96,55.76,35.17,1428432840,1428384320,48520,13.47777778
97,56.84,36.24,1428519355,1428470571,48784,13.55111111
98,60.35,35.37,1428605871,1428556822,49049,13.62472222
99,63.05,37.04,1428692386,1428643073,49313,13.69805556
100,43.61,31.97,1428778902,1428729325,49577,13.77138889
101,39.31,31.46,1428865417,1428815578,49839,13.84416667
102,51.62,27.91,1428951933,1428901831,50102,13.91722222
103,55.65,43.18,1429038449,1428988085,50364,13.99
104,53.36,37.08,1429124964,1429074340,50624,14.06222222
105,52.3,30.81,1429211480,1429160596,50884,14.13444444
106,51.67,35.4,1429297996,1429246852,51144,14.20666667
107,50.25,32.69,1429384512,1429333109,51403,14.27861111
108,50.1,31.06,1429471028,1429419367,51661,14.35027778
109,54.55,36.38,1429557545,1429505626,51919,14.42194444
110,59.92,33.47,1429644061,1429591886,52175,14.49305556
111,60.32,38.34,1429730577,1429678146,52431,14.56416667
112,63.13,38.49,1429817093,1429764408,52685,14.63472222
113,58.77,39.72,1429903609,1429850671,52938,14.705
114,51.02,34.02,1429990125,1429936934,53191,14.77527778
115,45.62,25.57,1430076641,1430023199,53442,14.845
116,44.68,21.47,1430163157,1430109466,53691,14.91416667
117,38.68,27.23,1430249673,1430195733,53940,14.98333333
118,41.87,31.08,1430336188,1430282001,54187,15.05194444
119,41.14,33.6,1430422704,1430368271,54433,15.12027778
120,40.51,27.45,1430509219,1430454542,54677,15.18805556
121,39.37,30.64,1430595734,1430540815,54919,15.25527778
122,57,33.42,1430682248,1430627089,55159,15.32194444
123,58,41.87,1430768762,1430713364,55398,15.38833333
124,53.71,39.41,1430855276,1430799641,55635,15.45416667
125,51.29,36.53,1430941790,1430885920,55870,15.51944444
126,53.04,32.35,1431028303,1430972200,56103,15.58416667
127,52.85,34.52,1431114815,1431058482,56333,15.64805556
128,50.22,38.88,1431201327,1431144765,56562,15.71166667
129,59.56,37.92,1431287838,1431231050,56788,15.77444444
130,60.26,43.67,1431374348,1431317338,57010,15.83611111
131,53.21,39.79,1431460858,1431403626,57232,15.89777778
132,52.53,36.18,1431547367,1431489917,57450,15.95833333
133,43.34,34.07,1431633875,1431576210,57665,16.01805556
134,57.11,38.28,1431720382,1431662505,57877,16.07694444
135,53.71,39.02,1431806888,1431748802,58086,16.135
136,53.49,36.71,1431893393,1431835101,58292,16.19222222
137,51.26,37.9,1431979897,1431921403,58494,16.24833333
138,44.83,35.5,1432066399,1432007706,58693,16.30361111
139,57.25,35.72,1432152900,1432094012,58888,16.35777778
140,55.18,39.04,1432239400,1432180321,59079,16.41083333
141,62.09,49.43,1432325898,1432266632,59266,16.46277778
142,61.48,45.55,1432412395,1432352945,59450,16.51388889
143,55.41,42.84,1432498890,1432439261,59629,16.56361111
144,57,40.75,1432585383,1432525580,59803,16.61194444
145,59.96,38.55,1432671875,1432611901,59974,16.65944444
146,52.85,38.27,1432758364,1432698225,60139,16.70527778
147,52.52,36.96,1432844852,1432784552,60300,16.75
148,51.8,38.28,1432931337,1432870882,60455,16.79305556
149,55.7,33.16,1433017820,1432957214,60606,16.835
150,53.13,36.58,1433104301,1433043550,60751,16.87527778
151,53.68,33.41,1433190780,1433129889,60891,16.91416667
152,55.37,35.33,1433277256,1433216231,61025,16.95138889
153,57.65,41.46,1433363730,1433302576,61154,16.98722222
154,63.22,39.99,1433450201,1433388925,61276,17.02111111
155,63.47,45.42,1433536669,1433475276,61393,17.05361111
156,55.72,40.07,1433623135,1433561631,61504,17.08444444
157,60.02,40.36,1433709597,1433647990,61607,17.11305556
158,52.51,38.14,1433796057,1433734352,61705,17.14027778
159,58.05,40.3,1433882514,1433820717,61797,17.16583333
160,63.29,40.59,1433968967,1433907086,61881,17.18916667
161,64.92,41.75,1434055418,1433993458,61960,17.21111111
162,67.73,41.66,1434141865,1434079834,62031,17.23083333
163,57.33,46.6,1434228309,1434166214,62095,17.24861111
164,47.29,42.03,1434314749,1434252597,62152,17.26444444
165,58.7,37.92,1434401186,1434338984,62202,17.27833333
166,64.71,49.19,1434487620,1434425374,62246,17.29055556
167,62.81,50.31,1434574050,1434511768,62282,17.30055556
168,55.24,41.92,1434660477,1434598166,62311,17.30861111
169,55.96,43.52,1434746900,1434684567,62333,17.31472222
170,64.86,47.56,1434833319,1434770972,62347,17.31861111
171,56.27,44.84,1434919735,1434857381,62354,17.32055556
172,53.51,40.45,1435006147,1434943793,62354,17.32055556
173,59.67,45.05,1435092555,1435030209,62346,17.31833333
174,63.12,43.24,1435178960,1435116629,62331,17.31416667
175,65.36,50.01,1435265361,1435203052,62309,17.30805556
176,64.61,55.43,1435351758,1435289478,62280,17.3
177,67.27,50.71,1435438152,1435375909,62243,17.28972222
178,66.6,55.03,1435524541,1435462342,62199,17.2775
179,66.32,51.3,1435610927,1435548779,62148,17.26333333
180,77.78,55.8,1435697310,1435635219,62091,17.2475
181,80.87,58.3,1435783689,1435721662,62027,17.22972222
182,70.5,53.5,1435870064,1435808109,61955,17.20972222
183,69.79,47.79,1435956435,1435894559,61876,17.18777778
184,72.06,54.42,1436042803,1435981012,61791,17.16416667
185,65.27,46.73,1436129167,1436067468,61699,17.13861111
186,64.7,46.05,1436215528,1436153926,61602,17.11166667
187,63.45,54.93,1436301886,1436240388,61498,17.08277778
188,55.87,47.66,1436388240,1436326852,61388,17.05222222
189,61.45,40.74,1436474590,1436413319,61271,17.01972222
190,72.78,50.46,1436560938,1436499789,61149,16.98583333
191,66.24,56.58,1436647282,1436586261,61021,16.95027778
192,65.09,53.78,1436733623,1436672736,60887,16.91305556
193,62.01,50.54,1436819961,1436759213,60748,16.87444444
194,62.91,52.28,1436906295,1436845692,60603,16.83416667
195,61.92,47.07,1436992627,1436932173,60454,16.79277778
196,64.38,45.97,1437078956,1437018657,60299,16.74972222
197,65.26,55.17,1437165282,1437105142,60140,16.70555556
198,61.48,52.86,1437251605,1437191630,59975,16.65972222
199,60.58,50.24,1437337925,1437278119,59806,16.61277778
200,64.2,46.18,1437424242,1437364610,59632,16.56444444
201,63.7,54.97,1437510557,1437451102,59455,16.51527778
202,59.84,46.9,1437596869,1437537596,59273,16.46472222
203,62.71,46.3,1437683179,1437624092,59087,16.41305556
204,59.07,43.23,1437769486,1437710589,58897,16.36027778
205,58.61,43.88,1437855791,1437797087,58704,16.30666667
206,59.59,43.02,1437942094,1437883587,58507,16.25194444
207,55.62,50.03,1438028394,1437970087,58307,16.19638889
208,53.51,47.31,1438114692,1438056589,58103,16.13972222
209,57.52,43.79,1438200988,1438143092,57896,16.08222222
210,58.29,45.94,1438287282,1438229596,57686,16.02388889
211,61.05,41.75,1438373573,1438316100,57473,15.96472222
212,61.67,47.53,1438459863,1438402606,57257,15.90472222
213,62.81,50.32,1438546151,1438489112,57039,15.84416667
214,67.57,57.24,1438632437,1438575619,56818,15.78277778
215,64.23,52.16,1438718721,1438662126,56595,15.72083333
216,66.99,54.4,1438805004,1438748634,56370,15.65833333
217,66.18,51.18,1438891284,1438835143,56141,15.59472222
218,62.5,45.63,1438977563,1438921652,55911,15.53083333
219,68.47,46.93,1439063841,1439008161,55680,15.46666667
220,67.04,54.83,1439150117,1439094671,55446,15.40166667
221,66.97,53.89,1439236391,1439181181,55210,15.33611111
222,62.2,47.07,1439322664,1439267692,54972,15.27
223,65.78,46.16,1439408935,1439354203,54732,15.20333333
224,65.13,46.82,1439495206,1439440714,54492,15.13666667
225,56.84,54.81,1439581474,1439527225,54249,15.06916667
226,61.4,46.52,1439667742,1439613736,54006,15.00166667
227,61.46,45.82,1439754008,1439700247,53761,14.93361111
228,63.54,48.71,1439840273,1439786759,53514,14.865
229,56.41,50.89,1439926537,1439873270,53267,14.79638889
230,68.39,55.34,1440012800,1439959782,53018,14.72722222
231,67.25,57.18,1440099062,1440046293,52769,14.65805556
232,70.45,61.38,1440185322,1440132805,52517,14.58805556
233,66.58,57.92,1440271582,1440219316,52266,14.51833333
234,70.53,57.49,1440357841,1440305828,52013,14.44805556
235,63.63,51.08,1440444099,1440392339,51760,14.37777778
236,62.97,51.52,1440530356,1440478851,51505,14.30694444
237,66,54.61,1440616612,1440565362,51250,14.23611111
238,61.9,50.89,1440702867,1440651873,50994,14.165
239,64.03,51.2,1440789121,1440738384,50737,14.09361111
240,63.91,52.89,1440875375,1440824895,50480,14.02222222
241,63.56,49.01,1440961628,1440911406,50222,13.95055556
242,56.68,50.44,1441047880,1440997917,49963,13.87861111
243,59.56,47.1,1441134132,1441084427,49705,13.80694444
244,56.53,45.39,1441220383,1441170938,49445,13.73472222
245,55.2,42.85,1441306634,1441257448,49186,13.66277778
246,57.79,43.57,1441392884,1441343959,48925,13.59027778
247,55.11,42.49,1441479133,1441430469,48664,13.51777778
248,63.83,38.16,1441565382,1441516979,48403,13.44527778
249,62.67,43.22,1441651631,1441603489,48142,13.37277778
250,54.93,47.29,1441737879,1441690000,47879,13.29972222
251,57.76,45.09,1441824126,1441776509,47617,13.22694444
252,64.35,47.88,1441910374,1441863019,47355,13.15416667
253,64.04,50.37,1441996621,1441949529,47092,13.08111111
254,59,45.3,1442082868,1442036039,46829,13.00805556
255,59.69,43.19,1442169114,1442122549,46565,12.93472222
256,56.51,44.12,1442255361,1442209059,46302,12.86166667
257,57.24,44.96,1442341607,1442295569,46038,12.78833333
258,57.52,39.86,1442427853,1442382078,45775,12.71527778
259,57.35,41.21,1442514098,1442468588,45510,12.64166667
260,57.56,47.01,1442600344,1442555098,45246,12.56833333
261,62.58,42.73,1442686590,1442641608,44982,12.495
262,58.96,46.47,1442772835,1442728118,44717,12.42138889
263,58.28,44.39,1442859081,1442814628,44453,12.34805556
264,56.29,40.88,1442945327,1442901139,44188,12.27444444
265,57.34,40.73,1443031572,1442987649,43923,12.20083333
266,55.98,42.89,1443117818,1443074160,43658,12.12722222
267,57.77,42.27,1443204064,1443160670,43394,12.05388889
268,58.37,44.21,1443290310,1443247181,43129,11.98027778
269,60.36,42.06,1443376556,1443333692,42864,11.90666667
270,60.82,42.02,1443462803,1443420204,42599,11.83305556
271,62.07,44.37,1443549050,1443506715,42335,11.75972222
272,61.01,41.92,1443635297,1443593227,42070,11.68611111
273,63.36,39.03,1443721544,1443679739,41805,11.6125
274,60.12,37.71,1443807792,1443766251,41541,11.53916667
275,49.18,43.32,1443894040,1443852764,41276,11.46555556
276,53.01,41.75,1443980288,1443939277,41011,11.39194444
277,59.49,39.12,1444066537,1444025790,40747,11.31861111
278,62.44,55.52,1444152787,1444112303,40484,11.24555556
279,55.39,43.21,1444239037,1444198817,40220,11.17222222
280,56.09,36.99,1444325287,1444285331,39956,11.09888889
281,58.18,40.56,1444411538,1444371846,39692,11.02555556
282,55.79,44.64,1444497790,1444458361,39429,10.9525
283,52.82,41.48,1444584042,1444544876,39166,10.87944444
284,51.29,36.83,1444670295,1444631392,38903,10.80638889
285,51.61,39.86,1444756549,1444717908,38641,10.73361111
286,51.94,37.88,1444842804,1444804424,38380,10.66111111
287,52.19,38.99,1444929059,1444890941,38118,10.58833333
288,51.01,41.37,1445015315,1444977458,37857,10.51583333
289,52.2,41.63,1445101572,1445063976,37596,10.44333333
290,50.5,41.98,1445187830,1445150494,37336,10.37111111
291,53.58,42.44,1445274089,1445237012,37077,10.29916667
292,53.25,40.2,1445360349,1445323531,36818,10.22722222
293,61.33,43.69,1445446610,1445410050,36560,10.15555556
294,55.2,40.05,1445532872,1445496569,36303,10.08416667
295,52.64,36.84,1445619135,1445583089,36046,10.01277778
296,51.71,36.28,1445705400,1445669609,35791,9.941944444
297,50.99,34.18,1445791665,1445756129,35536,9.871111111
298,53.29,35.7,1445877932,1445842650,35282,9.800555556
299,53.66,45.91,1445964200,1445929171,35029,9.730277778
300,53.52,42.63,1446050469,1446015692,34777,9.660277778
301,52.97,40.75,1446136740,1446102214,34526,9.590555556
302,57.3,43.2,1446223012,1446188735,34277,9.521388889
303,57.08,48.39,1446309286,1446275257,34029,9.4525
304,58.37,45.2,1446395561,1446361779,33782,9.383888889
305,54.72,43.85,1446481837,1446448301,33536,9.315555556
306,46.97,39.51,1446568116,1446534823,33293,9.248055556
307,50.92,45.78,1446654396,1446621345,33051,9.180833333
308,54.78,44.26,1446740677,1446707867,32810,9.113888889
309,57.94,50.8,1446826961,1446794389,32572,9.047777778
310,52.97,43.28,1446913246,1446880911,32335,8.981944444
311,54.95,38.65,1446999533,1446967432,32101,8.916944444
312,60.17,38.54,1447085822,1447053954,31868,8.852222222
313,60.61,54.85,1447172113,1447140475,31638,8.788333333
314,55.44,43.03,1447258406,1447226996,31410,8.725
315,54.99,40.17,1447344701,1447313516,31185,8.6625
316,38.78,32.58,1447430998,1447400036,30962,8.600555556
317,45.6,32.39,1447517298,1447486555,30743,8.539722222
318,58.57,45.41,1447603600,1447573074,30526,8.479444444
319,55.88,35.56,1447689904,1447659591,30313,8.420277778
320,51.64,33.99,1447776211,1447746109,30102,8.361666667
321,50.73,33.77,1447862520,1447832625,29895,8.304166667
322,42.67,34.32,1447948831,1447919140,29691,8.2475
323,36.81,25.76,1448035145,1448005654,29491,8.191944444
324,27.58,21.84,1448121462,1448092167,29295,8.1375
325,33.22,25.51,1448207782,1448178679,29103,8.084166667
326,40.48,27.13,1448294104,1448265190,28914,8.031666667
327,39.67,32.98,1448380429,1448351699,28730,7.980555556
328,42.46,32.2,1448466758,1448438207,28551,7.930833333
329,51.76,35.96,1448553089,1448524713,28376,7.882222222
330,51.7,27.84,1448639423,1448611217,28206,7.835
331,35.41,27.25,1448725760,1448697719,28041,7.789166667
332,41.32,25.45,1448812101,1448784220,27881,7.744722222
333,31.87,27.78,1448898445,1448870719,27726,7.701666667
334,53.58,30.13,1448984792,1448957215,27577,7.660277778
335,53.68,39.12,1449071143,1449043709,27434,7.620555556
336,50.02,29.11,1449157497,1449130201,27296,7.582222222
337,51.82,29,1449243854,1449216690,27164,7.545555556
338,53.41,50.61,1449330216,1449303177,27039,7.510833333
339,53.56,32.95,1449416580,1449389662,26918,7.477222222
340,52.53,35.13,1449502949,1449476143,26806,7.446111111
341,51.58,32.92,1449589321,1449562622,26699,7.416388889
342,52,32.11,1449675697,1449649098,26599,7.388611111
343,40.81,31.22,1449762077,1449735570,26507,7.363055556
344,32.83,29.07,1449848460,1449822040,26420,7.338888889
345,34.69,26.35,1449934848,1449908507,26341,7.316944444
346,34.68,30.15,1450021239,1449994970,26269,7.296944444
347,43.03,35.72,1450107634,1450081430,26204,7.278888889
348,44.01,36.52,1450194034,1450167886,26148,7.263333333
349,54.17,44.61,1450280437,1450254339,26098,7.249444444
350,55.53,51,1450366844,1450340788,26056,7.237777778
351,53.47,50.3,1450453256,1450427234,26022,7.228333333
352,59.03,52.91,1450539671,1450513676,25995,7.220833333
353,53.57,38.43,1450626090,1450600114,25976,7.215555556
354,41.53,34.79,1450712513,1450686548,25965,7.2125
355,54.68,38.3,1450798940,1450772979,25961,7.211388889
356,38.1,34.14,1450885371,1450859406,25965,7.2125
357,41.92,29.06,1450971806,1450945829,25977,7.215833333
358,41.92,29.63,1451058245,1451032248,25997,7.221388889
359,52.54,38.2,1451144687,1451118663,26024,7.228888889
360,42.23,32.85,1451231134,1451205074,26060,7.238888889
361,50.4,40.9,1451317584,1451291481,26103,7.250833333
362,44.06,38.09,1451404037,1451377885,26152,7.264444444
363,54.61,39.21,1451490494,1451464284,26210,7.280555556
364,35.54,29.23,1451576955,1451550679,26276,7.298888889
365,33.94,26.03,1451663419,1451637071,26348,7.318888889
366,40.79,34.42,1451749887,1451723459,26428,7.341111111
367,40.02,35.55,1451836358,1451809842,26516,7.365555556
368,38.13,35.45,1451922832,1451896222,26610,7.391666667
369,39.76,35.25,1452009309,1451982599,26710,7.419444444
370,36.54,34.96,1452095789,1452068971,26818,7.449444444
371,35.29,29.18,1452182272,1452155340,26932,7.481111111
372,34.73,27.03,1452268758,1452241705,27053,7.514722222
373,37.5,31.53,1452355246,1452328067,27179,7.549722222
374,35.43,27.65,1452441738,1452414425,27313,7.586944444
375,34.41,27.76,1452528231,1452500779,27452,7.625555556
376,33.51,30.37,1452614728,1452587130,27598,7.666111111
377,32.49,25.72,1452701226,1452673478,27748,7.707777778
378,30.85,21.1,1452787727,1452759822,27905,7.751388889
379,28.61,20.92,1452874230,1452846163,28067,7.796388889
380,34.63,22.07,1452960734,1452932501,28233,7.8425
381,25.77,21.04,1453047241,1453018836,28405,7.890277778
382,32.3,25.51,1453133749,1453105167,28582,7.939444444
383,39.69,34.34,1453220260,1453191496,28764,7.99
384,37.56,27.99,1453306771,1453277822,28949,8.041388889
385,31.44,23.17,1453393285,1453364145,29140,8.094444444
386,43.04,30.83,1453479799,1453450465,29334,8.148333333
387,42.01,36.42,1453566315,1453536782,29533,8.203611111
388,54.36,39.94,1453652833,1453623097,29736,8.26
389,53.77,33.65,1453739351,1453709409,29942,8.317222222
390,52.25,33.24,1453825870,1453795718,30152,8.375555556
391,52.05,26.4,1453912390,1453882026,30364,8.434444444
392,41.24,25.83,1453998912,1453968330,30582,8.495
393,50.88,34.39,1454085433,1454054633,30800,8.555555556
394,33.85,23.4,1454171956,1454140933,31023,8.6175
395,40.29,24.24,1454258479,1454227230,31249,8.680277778
396,52.5,31.19,1454345003,1454313526,31477,8.743611111
397,33.04,24.88,1454431527,1454399820,31707,8.8075
398,35.43,24.73,1454518052,1454486111,31941,8.8725
399,43.74,29.84,1454604577,1454572401,32176,8.937777778
400,41.69,31.54,1454691102,1454658688,32414,9.003888889
401,39.22,28.68,1454777628,1454744974,32654,9.070555556
402,34.68,27.71,1454864154,1454831258,32896,9.137777778
403,37.79,30.72,1454950680,1454917540,33140,9.205555556
404,32.95,28.51,1455037206,1455003821,33385,9.273611111
405,35.61,25.24,1455123732,1455090099,33633,9.3425
406,34.95,23.95,1455210258,1455176377,33881,9.411388889
407,37.19,27.15,1455296783,1455262652,34131,9.480833333
408,29.39,25.3,1455383309,1455348926,34383,9.550833333
409,27.1,21.63,1455469835,1455435199,34636,9.621111111
410,29.12,20.1,1455556361,1455521470,34891,9.691944444
411,29.83,19.32,1455642886,1455607740,35146,9.762777778
412,29.74,28.68,1455729411,1455694009,35402,9.833888889
413,34.73,24.6,1455815936,1455780276,35660,9.905555556
414,38.37,25.46,1455902461,1455866542,35919,9.9775
415,36.57,32.88,1455988985,1455952807,36178,10.04944444
416,50.2,30.97,1456075509,1456039071,36438,10.12166667
417,37.09,25.25,1456162033,1456125333,36700,10.19444444
418,36.1,25.13,1456248557,1456211595,36962,10.26722222
419,35.66,21.89,1456335080,1456297855,37225,10.34027778
420,32.63,19.45,1456421603,1456384115,37488,10.41333333
421,34.43,27.16,1456508125,1456470374,37751,10.48638889
422,33.44,27.04,1456594647,1456556631,38016,10.56
423,38.07,24.81,1456681169,1456642888,38281,10.63361111
424,31.59,22.75,1456767690,1456729144,38546,10.70722222
425,51.96,26.98,1456854211,1456815399,38812,10.78111111
426,34.44,25.8,1456940732,1456901654,39078,10.855
427,38.82,23.18,1457027252,1456987908,39344,10.92888889
428,30.69,26.84,1457113772,1457074161,39611,11.00305556
429,33.75,27.04,1457200292,1457160413,39879,11.0775
430,34.65,23.75,1457286811,1457246665,40146,11.15166667
431,35.38,20.83,1457373330,1457332916,40414,11.22611111
432,37.52,22.18,1457459849,1457419167,40682,11.30055556
433,32.35,32.12,1457546367,1457505417,40950,11.375
434,44.27,31.31,1457632885,1457591667,41218,11.44944444
435,43.34,32.37,1457719403,1457677917,41486,11.52388889
436,52.15,33.97,1457805921,1457764166,41755,11.59861111
437,52.85,37.37,1457892438,1457850414,42024,11.67333333
438,50.06,31.88,1457978955,1457936662,42293,11.74805556
439,39.04,32.34,1458065471,1458022910,42561,11.8225
440,39.94,31.92,1458151988,1458109158,42830,11.89722222
441,48.25,32.14,1458238504,1458195406,43098,11.97166667
442,38.35,31.01,1458325020,1458281653,43367,12.04638889
443,38.53,33.97,1458411536,1458367900,43636,12.12111111
444,50.42,34.39,1458498052,1458454147,43905,12.19583333
445,51.41,30.88,1458584568,1458540394,44174,12.27055556
446,46.07,32.07,1458671083,1458626641,44442,12.345
447,41.47,32.49,1458757599,1458712888,44711,12.41972222
448,43.19,34.68,1458844114,1458799135,44979,12.49416667
449,53.09,32.18,1458930629,1458885381,45248,12.56888889
450,52.95,33.41,1459017144,1458971628,45516,12.64333333
451,39.75,29.82,1459103659,1459057876,45783,12.7175
452,39.65,30.96,1459190174,1459144123,46051,12.79194444
453,40.93,31.18,1459276689,1459230370,46319,12.86638889
454,43.53,27.9,1459363204,1459316618,46586,12.94055556
455,49.59,30.21,1459449719,1459402865,46854,13.015
456,37.59,27.62,1459536234,1459489114,47120,13.08888889
457,44.55,37.45,1459622749,1459575362,47387,13.16305556
458,52.35,37.66,1459709264,1459661611,47653,13.23694444
459,50.19,37.75,1459795780,1459747860,47920,13.31111111
460,50.25,35.56,1459882295,1459834109,48186,13.385
461,37.97,31.1,1459968810,1459920359,48451,13.45861111
462,50.3,30.5,1460055325,1460006609,48716,13.53222222
463,50.66,36.58,1460141841,1460092860,48981,13.60583333
464,48.48,36.34,1460228356,1460179112,49244,13.67888889
465,51.47,29.57,1460314872,1460265364,49508,13.75222222
466,52.38,32.08,1460401387,1460351616,49771,13.82527778
467,41.69,36.06,1460487903,1460437869,50034,13.89833333
468,44.05,38.22,1460574419,1460524123,50296,13.97111111
469,40.91,37.06,1460660934,1460610378,50556,14.04333333
470,44.91,27.41,1460747450,1460696633,50817,14.11583333
471,35.74,25.5,1460833966,1460782889,51077,14.18805556
472,42.97,25.61,1460920482,1460869146,51336,14.26
473,52.91,35.34,1461006998,1460955404,51594,14.33166667
474,53.04,31.12,1461093514,1461041662,51852,14.40333333
475,57.92,30.83,1461180031,1461127922,52109,14.47472222
476,58.6,35.6,1461266547,1461214182,52365,14.54583333
477,43.05,31.95,1461353063,1461300444,52619,14.61638889
478,40.69,27.52,1461439579,1461386706,52873,14.68694444
479,42.91,28.26,1461526095,1461472970,53125,14.75694444
480,37.53,26.51,1461612611,1461559234,53377,14.82694444
481,33.94,25.22,1461699127,1461645500,53627,14.89638889
482,35.47,26.39,1461785643,1461731767,53876,14.96555556
483,36.79,22.94,1461872158,1461818035,54123,15.03416667
484,31.49,25.43,1461958674,1461904305,54369,15.1025
485,45.36,27.4,1462045189,1461990576,54613,15.17027778
486,51.01,30.76,1462131704,1462076848,54856,15.23777778
487,53.82,35.52,1462218218,1462163121,55097,15.30472222
488,53.08,33.62,1462304733,1462249397,55336,15.37111111
489,58.97,37.05,1462391247,1462335673,55574,15.43722222
490,62.27,38.95,1462477760,1462421951,55809,15.5025
491,61.35,44.21,1462564273,1462508231,56042,15.56722222
492,54.25,40.43,1462650786,1462594512,56274,15.63166667
493,67.95,43.84,1462737298,1462680795,56503,15.69527778
494,66.32,44.17,1462823809,1462767080,56729,15.75805556
495,61.19,43.42,1462910320,1462853367,56953,15.82027778
496,61.45,45.38,1462996830,1462939655,57175,15.88194444
497,59.51,42.05,1463083339,1463025946,57393,15.9425
498,41.49,33.27,1463169847,1463112238,57609,16.0025
499,51.86,31.75,1463256354,1463198532,57822,16.06166667
500,53.81,38.52,1463342861,1463284829,58032,16.12
501,56.44,36.18,1463429366,1463371127,58239,16.1775
502,61.39,36.36,1463515870,1463457428,58442,16.23388889
503,57.3,48.73,1463602373,1463543731,58642,16.28944444
504,57.09,44.97,1463688874,1463630037,58837,16.34361111
505,60.92,44.32,1463775374,1463716344,59030,16.39722222
506,60.64,50.7,1463861873,1463802654,59219,16.44972222
507,59.82,42.74,1463948370,1463888967,59403,16.50083333
508,58.06,38.63,1464034865,1463975282,59583,16.55083333
509,55.71,39.81,1464121359,1464061600,59759,16.59972222
510,43.39,39.04,1464207851,1464147921,59930,16.64722222
511,52.35,41.17,1464294341,1464234244,60097,16.69361111
512,56.47,47.02,1464380829,1464320571,60258,16.73833333
513,57.53,45.61,1464467315,1464406900,60415,16.78194444
514,57.12,41.91,1464553799,1464493232,60567,16.82416667
515,58.25,41.43,1464640280,1464579567,60713,16.86472222
516,53.48,42.64,1464726760,1464665905,60855,16.90416667
517,52.12,40.12,1464813237,1464752246,60991,16.94194444
518,55.92,37.76,1464899711,1464838590,61121,16.97805556
519,59.89,38.52,1464986183,1464924938,61245,17.0125
520,60.46,46.88,1465072652,1465011289,61363,17.04527778
521,64.49,43.31,1465159118,1465097643,61475,17.07638889
522,68.66,45.61,1465245581,1465184000,61581,17.10583333
523,73.09,49.55,1465332042,1465270361,61681,17.13361111
524,62.01,48.84,1465418499,1465356726,61773,17.15916667
525,66.19,48.6,1465504954,1465443094,61860,17.18333333
526,58.78,51.28,1465591405,1465529465,61940,17.20555556
527,57.12,50.27,1465677853,1465615840,62013,17.22583333
528,60.13,52.16,1465764298,1465702219,62079,17.24416667
529,56.18,52.79,1465850739,1465788601,62138,17.26055556
530,61.62,51.59,1465937177,1465874987,62190,17.275
531,58.39,51.09,1466023612,1465961376,62236,17.28777778
532,55.78,51.61,1466110043,1466047769,62274,17.29833333
533,54.5,45.2,1466196470,1466134166,62304,17.30666667
534,56.37,43.66,1466282894,1466220567,62327,17.31305556
535,62.58,45,1466369314,1466306971,62343,17.3175
536,64.76,53.95,1466455731,1466393378,62353,17.32027778
537,66.29,51.21,1466542144,1466479790,62354,17.32055556
538,69.02,52.16,1466628553,1466566205,62348,17.31888889
539,69.18,49.87,1466714959,1466652623,62336,17.31555556
540,63.18,50.57,1466801361,1466739046,62315,17.30972222
541,61.04,45.02,1466887759,1466825471,62288,17.30222222
542,63.09,51.42,1466974154,1466911900,62254,17.29277778
543,60.38,51.21,1467060544,1466998333,62211,17.28083333
544,59.93,45.04,1467146931,1467084769,62162,17.26722222
545,56,46.25,1467233315,1467171208,62107,17.25194444
546,60.38,45.2,1467319694,1467257651,62043,17.23416667
547,59.52,42.27,1467406070,1467344097,61973,17.21472222
548,57.68,40.1,1467492443,1467430546,61897,17.19361111
549,59.87,44.66,1467578812,1467516998,61814,17.17055556
550,63.71,50.58,1467665177,1467603453,61724,17.14555556
551,61.1,50.59,1467751539,1467689911,61628,17.11888889
552,61,42.08,1467837897,1467776372,61525,17.09027778
553,66.06,56.29,1467924252,1467862835,61417,17.06027778
554,64.15,55.24,1468010604,1467949302,61302,17.02833333
555,66.08,52.35,1468096952,1468035771,61181,16.99472222
556,65.48,58.06,1468183297,1468122242,61055,16.95972222
557,64.22,55.1,1468269639,1468208716,60923,16.92305556
558,59.9,45.74,1468355977,1468295193,60784,16.88444444
559,59.93,47.96,1468442313,1468381671,60642,16.845
560,63.54,43.86,1468528645,1468468152,60493,16.80361111
561,65.41,47.99,1468614975,1468554635,60340,16.76111111
562,65.93,56.52,1468701301,1468641120,60181,16.71694444
563,66.25,55.5,1468787625,1468727607,60018,16.67166667
564,75.02,55.3,1468873946,1468814095,59851,16.62527778
565,83.14,57.8,1468960264,1468900586,59678,16.57722222
566,71.86,61.99,1469046579,1468987078,59501,16.52805556
567,69.47,53.4,1469132892,1469073572,59320,16.47777778
568,71.93,57.48,1469219203,1469160067,59136,16.42666667
569,68.09,57.13,1469305511,1469246564,58947,16.37416667
570,66.84,57.4,1469391816,1469333061,58755,16.32083333
571,63.11,54.43,1469478119,1469419561,58558,16.26611111
572,64.12,51.46,1469564420,1469506061,58359,16.21083333
573,66.12,53.28,1469650719,1469592563,58156,16.15444444
574,59.6,46.85,1469737015,1469679065,57950,16.09722222
575,63.5,54.96,1469823309,1469765569,57740,16.03888889
576,62.33,47.62,1469909602,1469852073,57529,15.98027778
577,61.69,44.94,1469995892,1469938578,57314,15.92055556
578,63.79,47.09,1470082180,1470025084,57096,15.86
579,61.11,50.1,1470168467,1470111591,56876,15.79888889
580,63.77,57.49,1470254751,1470198098,56653,15.73694444
581,64.53,56.53,1470341034,1470284606,56428,15.67444444
582,65.2,54.52,1470427315,1470371115,56200,15.61111111
583,69.06,45.65,1470513595,1470457624,55971,15.5475
584,64.71,55.56,1470599873,1470544133,55740,15.48333333
585,61.78,50.16,1470686149,1470630643,55506,15.41833333
586,57.9,41.83,1470772424,1470717153,55271,15.35305556
587,59.28,42.45,1470858697,1470803663,55034,15.28722222
588,63.46,52.19,1470944969,1470890174,54795,15.22083333
589,62.1,57.42,1471031239,1470976685,54554,15.15388889
590,63.67,56.19,1471117509,1471063196,54313,15.08694444
591,61.58,54.19,1471203776,1471149707,54069,15.01916667
592,67.75,49.8,1471290043,1471236218,53825,14.95138889
593,69.13,47.81,1471376308,1471322730,53578,14.88277778
594,66.78,47.68,1471462573,1471409241,53332,14.81444444
595,66.82,53.53,1471548836,1471495753,53083,14.74527778
596,60.65,54.56,1471635098,1471582264,52834,14.67611111
597,61.97,54.18,1471721359,1471668776,52583,14.60638889
598,64.68,56.59,1471807619,1471755287,52332,14.53666667
599,69.14,55.42,1471893878,1471841799,52079,14.46638889
600,74.1,52.73,1471980136,1471928310,51826,14.39611111
601,68.72,56.85,1472066393,1472014822,51571,14.32527778
602,59.68,55.5,1472152649,1472101333,51316,14.25444444
603,65.35,53.63,1472238905,1472187844,51061,14.18361111
604,65.88,47.42,1472325159,1472274355,50804,14.11222222
605,60.2,53.06,1472411413,1472360866,50547,14.04083333
606,65.04,49.81,1472497666,1472447377,50289,13.96916667
607,68.31,54.08,1472583919,1472533888,50031,13.8975
608,64.47,54.71,1472670171,1472620399,49772,13.82555556
609,61.65,46.76,1472756422,1472706909,49513,13.75361111
610,63.18,53.53,1472842673,1472793420,49253,13.68138889
611,56.95,51.96,1472928923,1472879930,48993,13.60916667
612,62.2,52.73,1473015172,1472966441,48731,13.53638889
613,66.21,52.04,1473101421,1473052951,48470,13.46388889
614,71.88,60.73,1473187670,1473139461,48209,13.39138889
615,71.66,61.6,1473273918,1473225971,47947,13.31861111
616,63.97,56.18,1473360166,1473312481,47685,13.24583333
617,65.05,55.36,1473446414,1473398991,47423,13.17305556
618,61.17,45.88,1473532661,1473485501,47160,13.1
619,63.04,44.75,1473618908,1473572011,46897,13.02694444
620,69.33,53.26,1473705154,1473658520,46634,12.95388889
621,77.14,59.88,1473791400,1473745030,46370,12.88055556
622,62.37,56.31,1473877647,1473831540,46107,12.8075
623,72.11,55.9,1473963893,1473918050,45843,12.73416667
624,59.59,51.89,1474050138,1474004560,45578,12.66055556
625,61.58,45.12,1474136384,1474091070,45314,12.58722222
626,63.4,44.65,1474222630,1474177580,45050,12.51388889
627,58.97,52.57,1474308875,1474264090,44785,12.44027778
628,59.63,47.1,1474395121,1474350600,44521,12.36694444
629,61.47,50.77,1474481367,1474437110,44257,12.29361111
630,59.04,44.83,1474567612,1474523620,43992,12.22
631,60.2,42.41,1474653858,1474610131,43727,12.14638889
632,64.08,51.46,1474740104,1474696642,43462,12.07277778
633,60.46,43.25,1474826350,1474783152,43198,11.99944444
634,54.44,41.85,1474912596,1474869663,42933,11.92583333
635,62.11,50.86,1474998843,1474956175,42668,11.85222222
636,65.95,54.5,1475085089,1475042686,42403,11.77861111
637,60.83,43.77,1475171336,1475129198,42138,11.705
638,55.99,42.18,1475257584,1475215710,41874,11.63166667
639,54.01,41.4,1475343831,1475302222,41609,11.55805556
640,55.37,39.34,1475430079,1475388734,41345,11.48472222
641,57.53,37.32,1475516328,1475475247,41081,11.41138889
642,60.98,46.2,1475602576,1475561760,40816,11.33777778
643,56.75,42.82,1475688826,1475648274,40552,11.26444444
644,55.9,40.42,1475775076,1475734788,40288,11.19111111
645,54.58,50.3,1475861326,1475821302,40024,11.11777778
646,55.32,45.6,1475947577,1475907816,39761,11.04472222
647,52,41.01,1476033828,1475994331,39497,10.97138889
648,51.4,37.52,1476120081,1476080846,39235,10.89861111
649,51.3,41.91,1476206333,1476167362,38971,10.82527778
650,51.92,42.23,1476292587,1476253878,38709,10.7525
651,50.74,41.37,1476378841,1476340394,38447,10.67972222
652,52.34,42.28,1476465097,1476426911,38186,10.60722222
653,54.67,43.27,1476551353,1476513428,37925,10.53472222
654,55.55,40.79,1476637609,1476599945,37664,10.46222222
655,55.81,41.92,1476723867,1476686463,37404,10.39
656,43.11,37.3,1476810126,1476772981,37145,10.31805556
657,51.75,40.88,1476896385,1476859500,36885,10.24583333
658,52.57,43.14,1476982646,1476946019,36627,10.17416667
659,51.6,40.62,1477068908,1477032538,36370,10.10277778
660,45.39,39.16,1477155171,1477119058,36113,10.03138889
661,42.34,35.89,1477241435,1477205578,35857,9.960277778
662,46.11,35.69,1477327700,1477292098,35602,9.889444444
663,51.52,38.53,1477413966,1477378619,35347,9.818611111
664,54.15,43.57,1477500234,1477465140,35094,9.748333333
665,55.06,50.3,1477586503,1477551661,34842,9.678333333
666,54.99,44.25,1477672773,1477638182,34591,9.608611111
667,57.35,43.39,1477759045,1477724704,34341,9.539166667
668,54.54,46.85,1477845318,1477811225,34093,9.470277778
669,54.87,44.85,1477931593,1477897747,33846,9.401666667
670,43.27,29.47,1478017869,1477984269,33600,9.333333333
671,41.67,28.43,1478104147,1478070791,33356,9.265555556
672,40.29,32.41,1478190427,1478157313,33114,9.198333333
673,41.1,33.24,1478276708,1478243835,32873,9.131388889
674,33.26,27.01,1478362991,1478330357,32634,9.065
675,34.39,26.96,1478449275,1478416879,32396,8.998888889
676,33.75,29.14,1478535562,1478503401,32161,8.933611111
677,39.01,27.74,1478621851,1478589922,31929,8.869166667
678,36.44,26.49,1478708141,1478676443,31698,8.805
679,36.76,28.61,1478794434,1478762964,31470,8.741666667
680,32.74,32.26,1478880728,1478849485,31243,8.678611111
681,46.5,32.05,1478967025,1478936005,31020,8.616666667
682,42.5,31.92,1479053324,1479022524,30800,8.555555556
683,55.48,43.16,1479139625,1479109043,30582,8.495
684,56.53,37.91,1479225929,1479195561,30368,8.435555556
685,41.58,32.67,1479312235,1479282078,30157,8.376944444
686,34.18,28.56,1479398543,1479368595,29948,8.318888889
687,31.18,25.15,1479484854,1479455110,29744,8.262222222
688,30.98,26.41,1479571167,1479541625,29542,8.206111111
689,31.66,24.44,1479657483,1479628138,29345,8.151388889
690,31.07,24.78,1479743802,1479714650,29152,8.097777778
691,36.25,29.57,1479830124,1479801161,28963,8.045277778
692,39.1,30.67,1479916448,1479887671,28777,7.993611111
693,38.54,29.44,1480002776,1479974179,28597,7.943611111
694,42.73,29.85,1480089106,1480060685,28421,7.894722222
695,39.68,29.05,1480175440,1480147190,28250,7.847222222
696,39.77,34.98,1480261776,1480233693,28083,7.800833333
697,41.84,28.43,1480348116,1480320194,27922,7.756111111
698,33.91,21.9,1480434459,1480406693,27766,7.712777778
699,38.48,30.13,1480520806,1480493190,27616,7.671111111
700,43.15,36.39,1480607155,1480579685,27470,7.630555556
701,42.95,35.3,1480693508,1480666177,27331,7.591944444
702,39.78,34.75,1480779865,1480752668,27197,7.554722222
703,36.29,27.68,1480866225,1480839155,27070,7.519444444
704,36.82,28.78,1480952589,1480925640,26949,7.485833333
705,40.3,29.43,1481038957,1481012122,26835,7.454166667
706,55.09,40.76,1481125328,1481098602,26726,7.423888889
707,53.8,40.15,1481211703,1481185078,26625,7.395833333
708,53.92,39.47,1481298082,1481271552,26530,7.369444444
709,44.53,37.18,1481384464,1481358022,26442,7.345
710,41.42,35.02,1481470851,1481444490,26361,7.3225
711,42.82,32.55,1481557241,1481530954,26287,7.301944444
712,43.22,41.28,1481643635,1481617414,26221,7.283611111
713,45.24,39.48,1481730034,1481703872,26162,7.267222222
714,40.91,35.2,1481816436,1481790325,26111,7.253055556
715,43.87,39.36,1481902842,1481876776,26066,7.240555556
716,36.85,29.45,1481989252,1481963222,26030,7.230555556
717,43.55,34.94,1482075666,1482049665,26001,7.2225
718,40.81,33.34,1482162085,1482136104,25981,7.216944444
719,41.61,27.65,1482248507,1482222540,25967,7.213055556
720,35.17,28.59,1482334933,1482308971,25962,7.211666667
721,35.04,29.08,1482421363,1482395399,25964,7.212222222
722,39.64,30.46,1482507797,1482481823,25974,7.215
723,40.59,30.18,1482594234,1482568243,25991,7.219722222
724,52.92,35.07,1482680676,1482654659,26017,7.226944444
725,34,25.94,1482767121,1482741072,26049,7.235833333
726,37.19,27.7,1482853570,1482827480,26090,7.247222222
727,33.5,23.59,1482940023,1482913884,26139,7.260833333
728,33.9,24.39,1483026479,1483000284,26195,7.276388889
729,43.75,33.23,1483112939,1483086681,26258,7.293888889
730,39.65,27.76,1483199402,1483173074,26328,7.313333333
731,29.18,22.66,1483285869,1483259462,26407,7.335277778
732,29.02,22.66,1483372339,1483345847,26492,7.358888889
733,35.82,26.34,1483458812,1483432228,26584,7.384444444
734,36.66,28.98,1483545288,1483518605,26683,7.411944444